XXXXXXX2222XXXXXXX
X         A2   H0X
X                X
X                X
X    A3        A0X
X                X
X    XX   XH1    X
X     X XX       X
X    SXXA3       X
X     X XX H2    X
X    XX   X      X
X                X
X    A3        A1X
X     B2         X
X    A3          X
X              H0X
X          A2    X
XXXXXXX1111XXXXXXX